,enterprise_id,years,revenue,cost_of_goods_sold,gross_profit,gross_margin_%,"selling,_general,_&_admin._expense",research_&_development,other_operating_expense,total_operating_expense,operating_income,operating_margin_%,interest_income,interest_expense,net_interest_income,other_income_(expense),pretax_income,tax_provision,tax_rate_%,other_net_income_(loss),net_income_including_noncontrolling_interests,net_income_(continuing_operations),net_income_(discontinued_operations),other_income_(minority_interest),net_income,net_margin_%,preferred_dividends,eps_(basic),eps_(diluted),shares_outstanding_(diluted_average),ebit,"depreciation,_depletion_and_amortization",ebitda,ebitda_margin_%
0,28,1994,59827,39427,20400,34.098,4159,0,3261,7420,12980,21.696,0,0,0,-6405,6575,-2151,32.71,42,4466,4424,753,-151,4315,7.213,0,3.36,3.36,1313.889,12980,3261,16241,27.147
1,28,1995,59316,25755,33561,56.58,17367,0,3207,20574,12987,21.895,0,0,0,-4326,8661,-2746,31.71,-1019,4896,5915,-1189,-170,4726,7.968,0,3.693,3.693,1281.554,12987,3207,16194,27.301
2,28,1996,69276,27376,41900,60.483,21831,0,3594,25425,16475,23.782,0,0,0,-6738,9737,-3164,32.49,204,6777,6573,0,-204,6573,9.488,0,5.2,5.2,1262.859,16475,3594,20069,28.97
3,28,1997,78541,29086,49455,62.967,27329,0,3785,31114,18341,23.352,0,0,0,-7535,10806,-3526,32.63,269,7549,7280,0,-269,7280,9.269,0,5.867,5.76,1264.125,18341,3785,22126,28.171
4,28,1998,88540,36006,52534,59.334,30949,0,4082,35031,17503,19.769,0,0,0,-6324,11179,-2976,26.62,240,8443,8203,0,-240,8203,9.265,0,6.667,6.56,1254.375,17503,4082,21585,24.379
5,28,1999,100469,42280,58189,57.917,33091,0,1603,34694,23495,23.385,0,-9753,-9753,-265,13477,-4181,31.02,265,9561,9296,0,-265,9296,9.253,0,7.6,7.44,1248.75,23230,5860,29090,28.954
6,28,2000,111630,45958,65672,58.83,38046,0,1671,39717,25955,23.251,0,-10013,-10013,-365,15577,-4860,31.2,365,11082,10717,0,-365,10717,9.601,0,8.72,8.56,1249.5,25590,6691,32281,28.918
7,28,2001,129853,51823,78030,60.091,45392,0,2045,47437,30593,23.56,0,-11720,-11720,-427,18446,-5711,30.96,0,12735,12735,0,0,12735,9.807,0,10.32,10.16,1257.125,30166,6385,36551,28.148
8,28,2002,126416,49097,77319,61.162,43727,0,2481,46208,31111,24.61,0,-11062,-11062,-348,19701,-5573,28.29,-444,13684,14128,0,0,13684,10.825,0,11.04,10.96,1256.5,30763,7125,37888,29.971
9,28,2003,132210,52856,79354,60.021,46837,0,3084,49921,29433,22.262,0,-10216,-10216,-326,18891,-3758,19.89,-1015,14118,15133,0,0,14118,10.679,0,11.36,11.28,1253.5,29107,6511,35618,26.941
10,28,2004,112886,51206,61680,54.639,29549,0,3752,33301,28379,25.14,0,-10460,-10460,-308,17611,-3845,21.83,1470,15236,13766,2057,0,15236,13.497,0,12.16,12.08,1259.375,28071,6864,34935,30.947
11,28,2005,134291,61759,72532,54.011,36003,0,3888,39891,32641,24.306,0,-11616,-11616,-728,20297,-3696,18.21,559,17160,16601,559,0,17160,12.778,0,13.2,13.12,1305.625,31913,8348,40261,29.98
12,28,2006,136580,59784,76796,56.228,36652,0,3239,39891,36905,27.021,0,-14811,-14811,-916,21178,-3824,18.06,-634,16720,17354,-634,0,16720,12.242,0,12.64,12.56,1326.375,35989,7841,43830,32.091
13,28,2007,151568,66773,84795,55.945,38704,0,3062,41766,43029,28.389,0,-18879,-18879,-862,23288,-3944,16.94,1398,20742,19344,1398,0,20742,13.685,0,16,16,1299.25,42167,8457,50624,33.4
14,28,2008,172488,73125,99363,57.606,43642,0,4431,48073,51290,29.735,0,-23762,-23762,0,27528,-4155,15.09,-249,23124,23373,-249,-916,22208,12.875,0,17.44,17.36,1277.25,51290,10275,61565,35.692
15,28,2009,181581,83772,97809,53.865,45048,0,7233,52281,45528,25.073,0,-25758,-25758,0,19770,-1102,5.57,-617,18051,18668,-617,-641,17410,9.588,75,13.76,13.76,1262.25,45528,11481,57009,31.396
16,28,2010,155278,75921,79357,51.106,40426,0,10627,51053,28304,18.228,0,-18309,-18309,0,9995,1148,-11.49,82,11225,11143,82,-200,11025,7.1,300,8.08,8.08,1326.875,28304,10619,38923,25.067
17,28,2011,148416,71713,76703,51.681,41116,0,-34031,7085,69618,46.907,133,-15537,-15404,-40027,14187,-1039,7.32,-969,12179,13148,-969,-535,11644,7.846,300,8.48,8.48,1334.75,29724,9786,39510,26.621
18,28,2012,141479,68278,73201,51.74,0,0,3930,3930,69271,48.962,206,-14422,-14216,-34896,20159,-5745,28.5,29,14443,14414,29,-292,14151,10.002,1031,9.92,9.84,1327.5,34581,8986,43567,30.794
19,28,2013,144121,74310,69811,48.439,29694,0,10733,40427,29384,20.388,196,-12407,-12211,208,17381,-2534,14.58,-983,13864,14847,-983,-223,13641,9.465,0,10.32,10.32,1320.5,29788,9192,38980,27.047
20,28,2014,110137,79841,30296,27.508,17945,0,0,17945,12351,11.214,116,-2870,-2754,-497,9100,-1219,13.4,5474,13355,7881,5475,-298,13057,11.855,0,10.24,10.16,1286.125,11970,5202,17172,15.592
21,28,2015,116406,83704,32702,28.093,16848,0,0,16848,15854,13.62,0,-2800,-2800,-2791,10263,-773,7.53,5855,15345,9490,5855,-112,15233,13.086,0,12.08,12,1265.375,13063,4953,18016,15.477
22,28,2016,115158,82693,32465,28.192,17831,0,0,17831,14634,12.708,65,-3463,-3398,-3050,8186,-6485,79.22,-7495,-5794,1700,-7495,-332,-6126,-5.32,18,-4.96,-4.96,1252,11649,4847,16496,14.325
23,28,2017,119468,87652,31816,26.631,17638,0,0,17638,14178,11.868,263,-5024,-4761,-2386,7031,1133,-16.11,-953,7211,8165,-954,289,7500,6.278,656,6.08,6,1141.25,12055,7070,19125,16.009
24,28,2018,99279,75593,23686,23.858,26425,0,0,26425,-2739,-2.759,358,-4655,-4297,-4309,-11345,2808,24.75,-312,-8849,-8536,-312,365,-8484,-8.546,436,-8.24,-8.24,1085.875,-6690,6194,-496,-0.5
25,28,2019,97012,69403,27609,28.459,17433,3415,0,20848,6761,6.969,562,-4766,-4204,-23544,-20987,-93,-0.44,-1364,-22444,-21080,-1363,89,-22355,-23.044,447,-20.96,-20.96,1086.375,-16221,6582,-9639,-9.936
26,28,2020,90221,64852,25369,28.119,17100,3118,0,20218,5151,5.709,1507,-2927,-1420,-3785,-54,-552,-1022.22,-4307,-4913,-606,-4306,-66,-4979,-5.519,460,-4.99,-4.99,1091,2873,3541,6414,7.109
27,28,2021,75834,57871,17963,23.687,14989,2565,0,17554,409,0.539,0,-3515,-3515,9076,5970,487,-8.16,-911,5546,6457,-911,158,5704,7.522,474,4.63,4.63,1095,9485,3464,12949,17.076
28,28,2022,74196,53896,20300,27.36,14126,2497,0,16623,3677,4.956,621,-1876,-1255,-6105,-3683,286,7.77,-3194,-6591,-3396,-3195,71,-6520,-8.788,237,-6.16,-6.16,1098,-1807,3009,1202,1.62
29,28,2023,76556,55535,21021,27.458,15515,2813,0,18328,2693,3.518,456,-1607,-1151,-130,1412,-476,33.71,-644,292,936,-644,-67,225,0.294,289,-0.06,-0.06,1096,3019,3544,6563,8.573
