,enterprise_id,years,revenue,cost_of_goods_sold,gross_profit,gross_margin_%,"selling,_general,_&_admin._expense",research_&_development,other_operating_expense,total_operating_expense,operating_income,operating_margin_%,interest_income,interest_expense,net_interest_income,other_income_(expense),pretax_income,tax_provision,tax_rate_%,other_net_income_(loss),net_income_including_noncontrolling_interests,net_income_(continuing_operations),net_income_(discontinued_operations),other_income_(minority_interest),net_income,net_margin_%,preferred_dividends,eps_(basic),eps_(diluted),shares_outstanding_(diluted_average),ebit,"depreciation,_depletion_and_amortization",ebitda,ebitda_margin_%
0,36,1994,8782,2535,6247,71.134,2138,0,717,2855,3392,38.625,0,0,0,138,3530,-1235,34.99,0,2295,2295,0,0,2295,26.133,0,0.35,0.33,7056,3392,717,4109,46.789
1,36,1995,11521,5576,5945,51.601,1447,1111,0,2558,3387,29.399,0,0,0,216,3603,-1315,36.5,0,2288,2288,0,0,2288,19.859,0,0.35,0.33,6992,3387,1047,4434,38.486
2,36,1996,16202,7811,8391,51.79,1843,1296,0,3139,5252,32.416,0,0,0,386,5638,-2072,36.75,0,3566,3566,0,0,3566,22.01,0,0.54,0.51,7072,5252,1379,6631,40.927
3,36,1997,20847,9164,11683,56.042,2322,1808,0,4130,7553,36.231,0,0,0,381,7934,-2777,35,0,5157,5157,0,0,5157,24.737,0,0.79,0.73,7102,7553,1888,9441,45.287
4,36,1998,25070,9945,15125,60.331,2891,2347,0,5238,9887,39.438,0,0,0,772,10659,-3714,34.84,0,6945,6945,0,0,6945,27.702,0,1.07,0.97,7180,9887,2192,12079,48.181
5,36,1999,26273,12088,14185,53.991,3076,2509,56,5641,8544,32.52,0,0,0,593,9137,-3069,33.59,0,6068,6068,0,0,6068,23.096,0,0.91,0.865,7034,8544,2863,11407,43.417
6,36,2000,29389,11836,17553,59.726,3872,3111,411,7394,10159,34.567,0,0,0,1069,11228,-3914,34.86,0,7314,7314,0,0,7314,24.887,0,1.1,1.05,6940,10159,3597,13756,46.807
7,36,2001,33726,12650,21076,62.492,5089,3897,1586,10572,10504,31.145,0,0,0,4637,15141,-4606,30.42,0,10535,10535,0,0,10535,31.237,0,1.57,1.51,6986,10504,4835,15339,45.481
8,36,2002,26539,13487,13052,49.18,4464,3796,2338,10598,2454,9.247,0,0,0,-271,2183,-892,40.86,0,1291,1291,0,0,1291,4.865,0,0.19,0.19,6879,2454,6558,9012,33.958
9,36,2003,26764,13446,13318,49.761,4334,4034,548,8916,4402,16.448,0,0,0,-198,4204,-1087,25.86,0,3117,3117,0,0,3117,11.646,0,0.47,0.46,6759,4402,5344,9746,36.415
10,36,2004,30141,13047,17094,56.713,4278,4360,918,9556,7538,25.009,0,0,0,-96,7442,-1801,24.2,0,5641,5641,0,0,5641,18.715,0,0.86,0.85,6621,7538,5070,12608,41.83
11,36,2005,34209,14463,19746,57.722,4659,4778,179,9616,10130,29.612,0,0,0,287,10417,-2901,27.85,0,7516,7516,0,0,7516,21.971,0,1.17,1.16,6494,10130,4889,15019,43.904
12,36,2006,38826,15777,23049,59.365,5688,5145,126,10959,12090,31.139,0,0,0,520,12610,-3946,31.29,0,8664,8664,0,0,8664,22.315,0,1.42,1.4,6178,12090,4595,16685,42.974
13,36,2007,35382,17164,18218,51.489,6096,5873,42,12011,6207,17.543,0,0,0,861,7068,-2024,28.64,0,5044,5044,0,0,5044,14.256,0,0.87,0.86,5880,6207,4912,11119,31.426
14,36,2008,38334,18430,19904,51.923,5401,5755,243,11399,8505,22.187,0,0,0,661,9166,-2190,23.89,0,6976,6976,0,0,6976,18.198,0,1.2,1.18,5936,8505,4798,13303,34.703
15,36,2009,37586,16742,20844,55.457,5452,5722,6,11180,9664,25.712,592,-8,584,-2562,7686,-2394,31.15,0,5292,5292,0,0,5292,14.08,0,0.93,0.92,5748,7694,4616,12310,32.752
16,36,2010,35127,15566,19561,55.687,7931,5653,35,13619,5942,16.916,168,-1,167,-405,5704,-1335,23.4,0,4369,4369,0,0,4369,12.438,0,0.79,0.77,5645,5705,5052,10757,30.623
17,36,2011,43623,15132,28491,65.312,6309,6576,18,12903,15588,35.733,119,-10,109,348,16045,-4581,28.55,0,11464,11464,0,0,11464,26.28,0,2.06,2.01,5696,16045,4638,20683,47.413
18,36,2012,53999,20242,33757,62.514,7670,8350,260,16280,17477,32.365,98,-41,192,112,17781,-4839,27.21,0,12942,12942,0,0,12942,23.967,0,2.46,2.39,5411,17822,6064,23886,44.234
19,36,2013,53341,20190,33151,62.149,8057,10148,308,18513,14638,27.442,97,-90,94,141,14873,-3868,26.01,0,11005,11005,0,0,11005,20.631,0,2.2,2.13,5160,14963,7522,22485,42.153
20,36,2014,52708,21187,31521,59.803,8088,10611,291,18990,12531,23.774,104,-244,-151,231,12611,-2991,23.72,0,9620,9620,0,0,9620,18.252,0,1.94,1.89,5097,12855,8032,20887,39.628
21,36,2015,55870,20261,35609,63.735,8136,11537,294,19967,15642,27.997,141,-192,43,116,15801,-4097,25.93,0,11704,11704,0,0,11704,20.949,0,2.39,2.31,5056,15993,8549,24542,43.927
22,36,2016,55355,20676,34679,62.648,7930,12128,265,20323,14356,25.934,124,-337,-105,-39,14212,-2792,19.65,0,11420,11420,0,0,11420,20.631,0,2.41,2.33,4894,14549,8711,23260,42.02
23,36,2017,59387,23154,36233,61.012,8377,12685,294,21356,14877,25.051,222,-733,-703,-1238,12936,-2620,20.25,0,10316,10316,0,0,10316,17.371,0,2.18,2.12,4875,13669,7790,21459,36.134
24,36,2018,62761,23663,39098,62.297,7452,13035,177,20664,18434,29.372,441,-646,-349,2267,20352,-10751,52.83,0,9601,9601,0,0,9601,15.298,0,2.04,1.99,4835,20998,8129,29127,46.409
25,36,2019,70848,27111,43737,61.734,6950,13543,0,20493,23244,32.808,438,-468,126,-53,23317,-2264,9.71,0,21053,21053,0,0,21053,29.716,0,4.57,4.48,4701,23785,9085,32870,46.395
26,36,2020,71965,29825,42140,58.556,6350,13362,0,19712,22428,31.165,483,-489,484,1146,24058,-3010,12.51,0,21048,21048,0,0,21048,29.248,0,4.77,4.71,4473,24547,10826,35373,49.153
27,36,2021,77867,34255,43612,56.008,6180,13556,0,19736,23876,30.663,272,-629,-504,1706,25078,-4179,16.66,0,20899,20899,0,0,20899,26.839,0,4.98,4.94,4232,25707,12239,37946,48.732
28,36,2022,79024,35209,43815,55.445,6543,15190,0,21733,22082,27.943,144,-597,-482,103,21703,-1835,8.46,0,19868,19868,0,0,19868,25.142,0,4.89,4.86,4090,22300,11792,34092,43.141
29,36,2023,63054,36188,26866,42.608,7002,17528,0,24530,2336,3.705,589,-496,1166,4266,7768,249,-3.21,0,8017,8017,0,-3,8014,12.71,0,1.95,1.94,4123,8264,13035,21299,33.779
