,enterprise_id,years,revenue,cost_of_goods_sold,gross_profit,gross_margin_%,"selling,_general,_&_admin._expense",research_&_development,other_operating_expense,total_operating_expense,operating_income,operating_margin_%,interest_income,interest_expense,net_interest_income,other_income_(expense),pretax_income,tax_provision,tax_rate_%,other_net_income_(loss),net_income_including_noncontrolling_interests,net_income_(continuing_operations),net_income_(discontinued_operations),other_income_(minority_interest),net_income,net_margin_%,preferred_dividends,eps_(basic),eps_(diluted),shares_outstanding_(diluted_average),ebit,"depreciation,_depletion_and_amortization",ebitda,ebitda_margin_%
0,41,1994,2438,1387,1051,43.109,450,0,262,712,339,13.905,0,0,0,-148,191,-48,25.13,24,167,143,0,-49,118,4.84,0,0.44,0.435,271.264,339,262,601,24.651
1,41,1995,2711,1507,1204,44.412,409,58,273,740,464,17.116,0,0,0,-179,285,-82,28.77,61,264,203,0,-61,203,7.488,0,0.745,0.725,279.982,464,273,737,27.186
2,41,1996,3146,1777,1369,43.516,496,61,279,836,533,16.942,0,0,0,-149,384,-122,31.77,50,312,262,0,-50,262,8.328,0,0.945,0.91,288.294,533,279,812,25.811
3,41,1997,4449,2564,1885,42.369,688,72,420,1180,705,15.846,0,0,0,-313,392,-110,28.06,68,350,282,0,-68,282,6.339,0,0.925,0.885,318.076,705,420,1125,25.287
4,41,1998,4735,2764,1971,41.626,662,79,392,1133,838,17.698,0,0,0,-216,622,-151,24.28,0,471,416,0,-66,405,8.553,0,1.28,1.23,328.106,838,444,1282,27.075
5,41,1999,4833,2807,2026,41.92,644,72,467,1183,843,17.443,0,0,0,-291,552,-127,23.01,55,480,425,0,-55,425,8.794,0,1.34,1.3,326.712,843,467,1310,27.105
6,41,2000,4639,2732,1907,41.108,641,67,445,1153,754,16.254,0,0,0,-161,593,-152,25.63,35,476,441,0,-45,431,9.291,0,1.355,1.33,324.444,754,445,1199,25.846
7,41,2001,5043,3075,1968,39.024,683,65,513,1261,707,14.019,0,0,0,-224,483,-103,21.33,10,390,363,0,-27,363,7.198,0,1.14,1.125,322.184,707,471,1178,23.359
8,41,2002,5158,3060,2098,40.675,699,66,533,1298,800,15.51,0,0,0,-224,576,-135,23.44,7,448,432,0,-18,430,8.337,0,1.33,1.31,327.014,800,499,1299,25.184
9,41,2003,5128,2950,2178,42.473,751,69,435,1255,923,17.999,0,0,0,-206,717,-158,22.04,-130,429,548,0,-20,409,7.976,0,1.255,1.24,329.49,923,483,1406,27.418
10,41,2004,5613,3328,2285,40.709,766,75,522,1363,922,16.426,0,0,0,-151,771,-174,22.57,12,609,585,0,-24,585,10.422,0,1.79,1.77,330.991,922,517,1439,25.637
11,41,2005,6594,3987,2607,39.536,869,77,558,1504,1103,16.727,0,0,0,-155,948,-232,24.47,11,727,697,0,-30,697,10.57,0,2.14,2.1,331.403,1103,578,1681,25.493
12,41,2006,7656,4641,3015,39.381,987,80,655,1722,1293,16.889,0,0,0,-163,1130,-376,33.27,9,763,732,0,-37,726,9.483,0,2.24,2.2,329.685,1293,665,1958,25.575
13,41,2007,8324,4968,3356,40.317,1086,87,664,1837,1519,18.248,0,0,0,-155,1364,-355,26.03,10,1019,988,0,-31,988,11.869,0,3.05,3,329.293,1519,696,2215,26.61
14,41,2008,9402,5557,3845,40.896,1190,98,771,2059,1786,18.996,0,0,0,-173,1613,-419,25.98,26,1220,1177,0,-43,1177,12.519,0,3.69,3.62,324.842,1786,774,2560,27.228
15,41,2009,10796,6495,4301,39.839,1312,97,992,2401,1900,17.599,0,0,0,-215,1685,-465,27.6,36,1256,1211,0,-45,1211,11.217,0,3.87,3.8,318.302,1900,850,2750,25.472
16,41,2010,8956,5032,3924,43.814,1088,74,881,2043,1881,21.003,0,-133,-133,-306,1442,-169,11.72,24,1297,1297,0,-43,1254,14.002,0,4.08,4.01,312.382,1575,846,2421,27.032
17,41,2011,10116,5754,4362,43.12,1196,79,906,2181,2181,21.56,0,-125,-118,-99,1964,-768,39.1,38,1234,1234,0,-39,1195,11.813,0,3.9,3.84,311.395,2089,925,3014,29.794
18,41,2012,11252,6458,4794,42.606,1239,90,1003,2332,2462,21.881,0,-160,-145,6,2323,-641,27.59,40,1722,1722,0,-50,1672,14.86,0,5.53,5.45,306.722,2483,1003,3486,30.981
19,41,2013,11224,6396,4828,43.015,1270,98,1001,2369,2459,21.908,0,-156,-141,-22,2296,-586,25.52,34,1744,1744,0,-52,1692,15.075,0,5.67,5.61,301.845,2452,1001,3453,30.764
20,41,2014,11925,6744,5181,43.447,1349,98,1109,2556,2625,22.013,0,-182,-178,0,2447,-649,26.52,38,1836,1836,0,-81,1755,14.717,0,5.94,5.87,298.965,2629,1109,3738,31.346
21,41,2015,12273,6962,5311,43.274,1308,96,1170,2574,2737,22.301,0,-213,-213,-129,2395,-691,28.85,42,1746,1746,0,-52,1694,13.803,0,5.79,5.73,295.608,2608,1170,3778,30.783
22,41,2016,10776,5960,4816,44.692,1152,93,1106,2351,2465,22.875,0,-161,-161,-144,2160,-612,28.33,43,1591,1591,0,-44,1547,14.356,0,5.39,5.35,289.055,2321,1106,3427,31.802
23,41,2017,10534,5855,4679,44.418,1145,92,1122,2359,2320,22.024,0,-190,-190,-82,2048,-551,26.9,41,1538,1538,0,-38,1500,14.24,0,5.25,5.21,287.757,2238,1122,3360,31.897
24,41,2018,11358,6382,4976,43.811,1207,93,1184,2484,2492,21.941,41,-202,-161,-44,2287,-1026,44.86,47,1308,1308,0,-61,1247,10.979,0,4.36,4.32,289.114,2489,1184,3673,32.338
25,41,2019,14836,9020,5816,39.202,1629,113,1830,3572,2244,15.125,80,-303,-202,3007,5049,-817,16.18,173,4405,4288,117,-24,4381,29.53,0,13.26,13.11,334.127,5352,1830,7182,48.409
26,41,2020,28228,16644,11584,41.037,3457,184,4675,8316,3268,11.577,112,-246,-38,-303,2927,-769,26.27,223,2381,2272,109,-96,2285,8.095,0,4.22,4.19,545.17,3173,4675,7848,27.802
27,41,2021,27243,15383,11860,43.534,3193,152,4626,7971,3889,14.275,140,-255,-115,-390,3384,-847,25.03,89,2626,2622,4,-125,2501,9.18,0,4.75,4.71,531.157,3639,4626,8265,30.338
28,41,2022,30793,17543,13250,43.029,3189,143,4635,7967,5283,17.157,93,-170,-77,-107,5099,-1262,24.75,124,3961,3956,5,-135,3826,12.425,0,7.4,7.33,521.875,5269,4635,9904,32.163
29,41,2023,33364,19450,13914,41.704,3107,143,4204,7454,6460,19.362,152,-215,-63,-854,5543,-1434,25.87,172,4281,4281,0,-134,4147,12.43,0,8.3,8.23,504.038,5758,4204,9962,29.859
