,enterprise_id,years,revenue,cost_of_goods_sold,gross_profit,gross_margin_%,"selling,_general,_&_admin._expense",research_&_development,other_operating_expense,total_operating_expense,operating_income,operating_margin_%,interest_income,interest_expense,net_interest_income,other_income_(expense),pretax_income,tax_provision,tax_rate_%,other_net_income_(loss),net_income_including_noncontrolling_interests,net_income_(continuing_operations),net_income_(discontinued_operations),other_income_(minority_interest),net_income,net_margin_%,preferred_dividends,eps_(basic),eps_(diluted),shares_outstanding_(diluted_average),ebit,"depreciation,_depletion_and_amortization",ebitda,ebitda_margin_%
0,48,1994,4649,526,4123,88.686,1550,610,237,2397,1726,37.126,0,0,0,-4,1722,-576,33.45,0,1146,1146,0,0,1146,24.651,0,0.118,0.118,9760,1726,237,1963,42.224
1,48,1995,5937,608,5329,89.759,2162,860,269,3291,2038,34.327,0,0,0,129,2167,-714,32.95,0,1453,1453,0,0,1453,24.474,0,0.145,0.145,10032,2038,269,2307,38.858
2,48,1996,8671,708,7963,91.835,4405,1432,-952,4885,3078,35.498,0,0,0,301,3379,-1184,35.04,0,2195,2195,0,0,2195,25.314,0,0.235,0.215,10209.302,3078,480,3558,41.033
3,48,1997,11936,1613,10323,86.486,3032,1863,557,5452,4871,40.809,0,0,0,443,5314,-1860,35,0,3454,3454,0,0,3454,28.938,15,0.36,0.33,10421.212,4871,557,5428,45.476
4,48,1998,15262,1436,13826,90.591,3491,2601,1024,7116,6710,43.965,0,0,0,407,7117,-2627,36.91,0,4490,4490,0,0,4490,29.42,28,0.46,0.42,10724,6710,1024,7734,50.675
5,48,1999,19747,1804,17943,90.864,3920,2970,1010,7900,10043,50.858,0,0,0,1848,11891,-4106,34.53,0,7785,7785,0,0,7785,39.424,28,0.77,0.71,10964,10043,926,11053,55.973
6,48,2000,22956,3002,19954,86.923,5176,3772,0,8948,11006,47.944,0,0,0,3269,14275,-4854,34,0,9421,9421,0,0,9421,41.039,14,0.89,0.85,11067.059,11006,1250,12256,53.389
7,48,2001,25296,3455,21841,86.342,5742,4379,0,10121,11720,46.331,0,0,0,-195,11525,-3804,33.01,-375,7346,7721,0,0,7346,29.04,0,0.69,0.66,11148,11720,1536,13256,52.404
8,48,2002,28365,5191,23174,81.699,6957,4307,0,11264,11910,41.988,0,0,0,-397,11513,-3684,32,0,7829,7829,0,0,7829,27.601,0,0.72,0.7,11106,11910,1084,12994,45.81
9,48,2003,32187,6059,26128,81.176,9988,6595,0,16583,9545,29.655,0,0,0,1509,11054,-3523,31.87,0,7531,7531,0,0,7531,23.398,0,0.7,0.69,10882,9545,1393,10938,33.983
10,48,2004,36835,6716,30119,81.767,13306,7779,0,21085,9034,24.526,0,0,0,3162,12196,-4028,33.03,0,8168,8168,0,0,8168,22.175,0,0.76,0.75,10894,9034,1186,10220,27.745
11,48,2005,39788,6031,33757,84.842,13099,6097,0,19196,14561,36.597,0,0,0,2067,16628,-4374,26.31,0,12254,12254,0,0,12254,30.798,0,1.13,1.12,10906,14561,855,15416,38.745
12,48,2006,44282,7650,36632,82.724,13576,6584,0,20160,16472,37.198,1510,0,1510,280,18262,-5663,31.01,0,12599,12599,0,0,12599,28.452,0,1.21,1.2,10531,16472,903,17375,39.237
13,48,2007,51122,10693,40429,79.083,14870,7121,0,21991,18438,36.067,1319,0,1319,344,20101,-6036,30.03,0,14065,14065,0,0,14065,27.513,0,1.44,1.42,9886,18438,1440,19878,38.884
14,48,2008,60420,11598,48822,80.804,18387,8164,0,26551,22271,36.86,888,-106,-106,1649,23814,-6133,25.75,0,17681,17681,0,0,17681,29.264,0,1.9,1.87,9470,23920,2056,25976,42.992
15,48,2009,58437,12155,46282,79.2,16909,9010,0,25919,20363,34.846,744,-38,706,-1248,19821,-5252,26.5,0,14569,14569,0,0,14569,24.931,0,1.63,1.62,8996,19859,2562,22421,38.368
16,48,2010,62484,12395,50089,80.163,17277,8714,0,25991,24098,38.567,0,-151,-151,1066,25013,-6253,25,0,18760,18760,0,0,18760,30.024,0,2.13,2.1,8927,25164,2673,27837,44.551
17,48,2011,69943,15577,54366,77.729,18162,9043,0,27205,27161,38.833,900,-295,-295,1205,28071,-4921,17.53,0,23150,23150,0,0,23150,33.098,0,2.73,2.69,8593,28366,2766,31132,44.511
18,48,2012,73723,17530,56193,76.222,18426,9811,0,28237,27956,37.92,0,-380,-380,-5309,22267,-5289,23.75,0,16978,16978,0,0,16978,23.029,0,2.02,2,8506,22647,2967,25614,34.744
19,48,2013,77849,20385,57464,73.815,20289,10411,0,30700,26764,34.379,0,-429,-429,717,27052,-5189,19.18,0,21863,21863,0,0,21863,28.084,0,2.61,2.58,8470,27481,3755,31236,40.124
20,48,2014,86833,27078,59755,68.816,20488,11381,0,31869,27886,32.115,0,-597,-597,531,27820,-5746,20.65,0,22074,22074,0,0,22074,25.421,0,2.66,2.63,8399,28417,5212,33629,38.728
21,48,2015,93580,33038,60542,64.695,20324,12046,0,32370,28172,30.105,0,-781,-781,-8884,18507,-6314,34.12,0,12193,12193,0,0,12193,13.03,0,1.49,1.48,8254,19288,5957,25245,26.977
22,48,2016,91154,32780,58374,64.039,19198,11988,0,31186,27188,29.826,0,-1243,-1243,-306,25639,-5100,19.89,0,20539,20539,0,0,20539,22.532,0,2.59,2.56,8013,26882,6622,33504,36.755
23,48,2017,96571,34261,62310,64.522,19942,13037,0,32979,29331,30.373,1387,-2222,-835,1405,29901,-4412,14.76,0,25489,25489,0,0,25489,26.394,0,3.29,3.25,7832,32123,8778,40901,42.353
24,48,2018,110360,38353,72007,65.247,22223,14726,0,36949,35058,31.767,2214,-2733,-519,1935,36474,-19903,54.57,0,16571,16571,0,0,16571,15.015,0,2.15,2.13,7794,39207,10261,49468,44.824
25,48,2019,125843,42910,82933,65.902,23098,16876,0,39974,42959,34.137,2762,-2686,76,653,43688,-4448,10.18,0,39240,39240,0,0,39240,31.182,0,5.11,5.06,7753,46374,11682,58056,46.134
26,48,2020,143015,46078,96937,67.781,24709,19269,0,43978,52959,37.03,2680,-2591,89,-12,53036,-8755,16.51,0,44281,44281,0,0,44281,30.963,0,5.82,5.76,7683,55627,12796,68423,47.843
27,48,2021,168088,52232,115856,68.926,25224,20716,0,45940,69916,41.595,2131,-2346,-215,1401,71102,-9831,13.83,0,61271,61271,0,0,61271,36.452,0,8.12,8.05,7608,73448,11686,85134,50.649
28,48,2022,198270,62650,135620,68.402,27725,24512,0,52237,83383,42.055,2094,-2063,31,302,83716,-10978,13.11,0,72738,72738,0,0,72738,36.686,0,9.7,9.65,7540,85779,14460,100239,50.557
29,48,2023,211915,65863,146052,68.92,30334,27195,0,57529,88523,41.773,2994,-1968,1026,-238,89311,-16950,18.98,0,72361,72361,0,0,72361,34.146,0,9.72,9.68,7472,91279,13861,105140,49.614
