,enterprise_id,years,revenue,cost_of_goods_sold,gross_profit,gross_margin_%,"selling,_general,_&_admin._expense",research_&_development,other_operating_expense,total_operating_expense,operating_income,operating_margin_%,interest_income,interest_expense,net_interest_income,other_income_(expense),pretax_income,tax_provision,tax_rate_%,other_net_income_(loss),net_income_including_noncontrolling_interests,net_income_(continuing_operations),net_income_(discontinued_operations),other_income_(minority_interest),net_income,net_margin_%,preferred_dividends,eps_(basic),eps_(diluted),shares_outstanding_(diluted_average),ebit,"depreciation,_depletion_and_amortization",ebitda,ebitda_margin_%
0,64,1994,20736,15422,5314,25.627,2547,1137,815,4499,815,3.93,0,0,0,8,823,-336,40.83,86,573,487,0,-86,487,2.349,43,0.223,0.208,1008.376,815,815,1630,7.861
1,64,1995,20801,15492,5309,25.523,2536,978,840,4354,955,4.591,0,0,0,14,969,-384,39.63,107,692,585,0,-107,585,2.812,32,0.28,0.275,985.088,955,840,1795,8.629
2,64,1996,22624,16756,5868,25.937,2651,963,844,4458,1410,6.232,0,0,0,-196,1214,-464,38.22,130,880,750,0,-130,750,3.315,21,0.184,0.179,976.568,1410,844,2254,9.963
3,64,1997,22788,16574,6214,27.269,2796,1122,841,4759,1455,6.385,0,0,0,-55,1400,-494,35.29,101,1007,906,0,-101,906,3.976,0,0.453,0.435,951.896,1455,841,2296,10.076
4,64,1998,21062,15139,5923,28.122,2611,1069,707,4387,1536,7.293,0,0,0,-60,1476,-514,34.82,208,1170,962,110,-98,1072,5.09,32,0.555,0.525,916.284,1536,707,2243,10.65
5,64,1999,22787,16167,6620,29.052,2737,1168,730,4635,1985,8.711,0,0,0,-260,1725,-568,32.93,183,1340,1157,98,-85,1255,5.508,33,0.67,0.633,900.208,1985,730,2715,11.915
6,64,2000,23844,17366,6478,27.168,3133,1292,819,5244,1234,5.175,0,0,0,-68,1166,-325,27.87,781,1622,841,690,-91,1531,6.421,33,1.61,1.505,995.349,1234,819,2053,8.61
7,64,2001,26583,18970,7613,28.639,3171,1302,0,4473,3140,11.812,0,-382,-382,0,2758,-853,30.93,0,1905,1808,0,-97,1808,6.801,32,1.89,1.775,1016,3140,859,3999,15.043
8,64,2002,27897,20087,7810,27.996,3323,1254,0,4577,3233,11.589,0,-426,-426,0,2807,-755,26.9,0,2052,2052,0,-114,1938,6.947,0,2.03,1.915,1010.8,3233,905,4138,14.833
9,64,2003,28212,20161,8051,28.538,3203,1191,0,4394,3657,12.963,0,-381,-381,0,3276,-887,27.08,0,2389,2389,0,-153,2236,7.926,0,2.335,2.21,1011.2,3657,727,4384,15.54
10,64,2004,31034,22508,8526,27.473,3654,1027,0,4681,3845,12.39,0,-375,-375,0,3470,-941,27.12,0,2529,2529,0,-168,2361,7.608,0,4.93,4.69,1014,3845,799,4644,14.964
11,64,2005,37445,27242,10203,27.248,4635,1267,0,5902,4301,11.486,0,-363,-363,0,3938,-1031,26.18,0,2907,2673,0,-234,2673,7.139,0,2.69,2.64,1011,4301,978,5279,14.098
12,64,2006,42725,30935,11790,27.595,5241,1367,0,6608,5182,12.129,0,-498,-498,0,4684,-1253,26.75,-95,3336,3164,0,-267,3069,7.183,0,3.1,3.03,1014,5182,984,6166,14.432
13,64,2007,47829,34740,13089,27.366,5462,1529,0,6991,6098,12.75,0,-606,-606,0,5492,-1494,27.2,0,3998,3998,0,-266,3732,7.803,0,3.81,3.71,1006,6098,1033,7131,14.909
14,64,2008,54759,39922,14837,27.095,6109,1678,0,7787,7050,12.875,0,-666,-666,0,6384,-1836,28.76,0,4548,4548,0,-324,4224,7.714,0,4.38,4.27,989,7050,1173,8223,15.017
15,64,2009,59757,43637,16120,26.976,6724,1771,0,8495,7625,12.76,0,-689,-689,0,6936,-1883,27.15,0,5053,5053,0,-364,4689,7.847,0,5,4.9,956,7625,1321,8946,14.971
16,64,2010,52425,38861,13564,25.873,6036,1558,-407,7187,6377,12.164,88,-705,-617,0,5760,-1581,27.45,0,4179,4179,0,-350,3829,7.304,0,4.17,4.12,928.8,6465,1258,7723,14.732
17,64,2011,52275,37954,14321,27.396,5798,1656,-31,7423,6898,13.196,101,-751,-650,0,6248,-1725,27.61,188,4711,4523,188,-338,4373,8.365,0,4.82,4.74,922.7,6999,1300,8299,15.876
18,64,2012,55754,40369,15385,27.594,6161,1951,-573,7539,7846,14.073,177,-673,-496,0,7350,-2134,29.03,148,5364,5216,148,-385,4979,8.93,0,5.58,5.49,906.8,8023,1263,9286,16.655
19,64,2013,57708,42153,15555,26.955,6452,2371,-952,7871,7684,13.315,120,-893,-773,0,6911,-1711,24.76,283,5483,5200,283,-353,5130,8.89,0,5.73,5.66,906.6,7804,1524,9328,16.164
20,64,2014,56600,40468,16132,28.502,6364,2342,-1123,7583,8549,15.104,137,-1032,-895,0,7654,-1999,26.12,456,6111,5655,456,-390,5721,10.108,0,6.35,6.25,915.1,8686,1735,10421,18.412
21,64,2015,57900,40898,17002,29.364,6172,2475,-1238,7409,9593,16.568,218,-1099,-881,0,8712,-2244,25.76,154,6622,6468,154,-402,6220,10.743,0,6.92,6.82,911.6,9811,1820,11631,20.088
22,64,2016,56098,40431,15667,27.928,5886,2279,211,8376,7291,12.997,121,-945,-824,0,6467,-2111,32.64,3612,7968,4356,3612,-360,7608,13.562,0,8.72,8.61,883.2,7412,1863,9275,16.534
23,64,2017,57244,41471,15773,27.554,5958,2376,-782,7552,8221,14.361,122,-1161,-1039,-49,7133,-1697,23.79,-10,5426,5436,-10,-371,5055,8.831,0,6.18,6.13,826.1,8294,1962,10256,17.916
24,64,2018,59837,44201,15636,26.131,6429,2427,-1358,7498,8138,13.6,108,-1017,-909,534,7763,-2843,36.62,0,4920,4920,0,-368,4552,7.607,0,5.76,5.7,799.1,8780,2140,10920,18.25
25,64,2019,34701,27465,7236,20.852,2864,1878,-383,4359,2877,8.291,150,-1182,-1032,659,2504,-1098,43.85,4053,5459,1406,4053,-190,5269,15.184,0,6.58,6.5,810.1,3686,1896,5582,16.086
26,64,2020,45349,34598,10751,23.707,3711,2452,-326,5837,4914,10.836,120,-1711,-1591,829,4152,-421,10.14,2217,5948,3731,2217,-411,5537,12.21,0,6.48,6.41,863.9,5863,2708,8571,18.9
27,64,2021,56587,48056,8531,15.076,5540,2582,-885,7237,1294,2.287,42,-1408,-1366,-2281,-2353,-575,-24.44,-367,-3295,-2928,-367,-224,-3519,-6.219,0,-2.59,-2.59,1357.8,-945,4156,3211,5.674
28,64,2022,64388,51897,12491,19.4,5224,2732,-423,7533,4958,7.7,36,-1330,-1294,1267,4931,-786,15.94,-33,4112,4145,-33,-248,3864,6.001,0,2.57,2.57,1508.5,6261,4557,10818,16.801
29,64,2023,67074,53406,13668,20.377,5663,2711,-120,8254,5414,8.072,70,-1300,-1230,1843,6027,-700,11.61,-19,5308,5327,-19,-111,5197,7.748,0,3.52,3.52,1485.9,7327,4108,11435,17.048
